2
1 6
68 35
6
5 811
811 5
3016 3139
3139 3016
4828 5634
5634 4828
111225222220021111111200000002120000000000000000000211200000
000211111120021112000000000000000000021200000021111200000000
112211111120000000000000000000000002120002111200021200000000
112211111120212000000000000002111200000002111112000000000000
000211111120000000000000212000000000000000000000000212000000
120211111122000000000000000000000000000022222212000000000000
000211111112000000000000000000000000000021111200000000212000
000211112222000000000000000000000000000021611200000000212000
000211112225220000000000000000000000000021111200000000212000
000211122211120000000000000000000000000021111200000000212000
000221122211120000000000000000000000000021111200000000000000
000021122111120000000000000000000000000021111200000000000000
000021122111122222220000000000000000000221111200000002120000
000021122111112111120000000000000000002111111200000002120000
000022222111111111122122222200000222222111111200000002121200
120000022111111111122221111222222111111111111200000000021200
120000021111111111111111111111111111111111111200000000000000
122120021111111111111111111111111111111111111200000021212000
002120021111111111111111111111111111111111111200000021200000
112120022222222222211111111111111111111111111200000021120000
000000000000000000222111111111111111111111122200000000000000
000000000000000000002111111211111111111111120000000000000000
000000000000000000002211111111111111111111120000000000000000
000000000000000000000211111111111111111111120000000000000000
000000000000000002120221111111111111111111120000000000000000
000000000000000000000211111111111111111111120000000000000000
000000000212000000000211111111111111111111120000000000000000
021200000000000000000211111122222222221111120000000000000000
000000000211221200000221111200000021122222122222222200000000
002122120000000222000211111200000000000002111112111200000000
000000000000022252222211111200000000002222111111111202112000
000000000000021111111111111221221200002522111111111200000000
000000000000211111111111111200000021121111111111111200000000
021200000000211111111111111222222222221111111111122221221120
000000000000211111111112111111121111111111111111220021221120
000000000002111111111111111111111111111111111112200021112000
000000000002111111111111111111111111111111111122000021120000
000000000002111111111111111111111111111111111120000000000000
000000000002111111111111111111111111121111111120000000000000
000000000002222222222221100000001111111111111120000000000000
000000000000000000000022100000000000111111111220000000000000
000000000000000000000002000000000000011111122200000000000000
000000000000000000000002000000000000011111112000000000000000
000000000000000000000002000000000000011111112000000000000000
000000000000000000000002711000000000011111112000000000000000
000000002121221212000002111111111111111111112000000000000000
021212000000000002120002111111111111111111112000000000000000
000000000000000000021202222222222222221112222000000000000000
000000000000000000000211202252222222221112200000000000000000
000000000000000000000000002111111111111111200000211112000000
000000000000000000000002222111111111111111200000000000000000
000000000000000000000002112111111111111111200002120000000000
000000000021120211200002112111111111111111200000000000000000
002120000000000000000002112111111111111111200000000000000000
000000000000000000000002112111111111111112200000000000000000
212000000000000000000002112221111121111112000000000000000000
000000000000000000000002111122222252222222000000000000000000
021200000000000000021202111111111111221212000000000000000000
000000000000000000021202222222222111222222200000000000000000
000000000000000000021200002222222111111111222120000000000000
000000000000000000021221122111112111111111112120212000000000
000000021200212120021221122111112111111111112120000000000000
021212120000000000021221122111112111111111122000000000000000
000000000002120212120211122111112111111111120000000000000000
000000000212120212121211202111111111111111120000000000000000
000000211202111212121221202111112111111112220000000000000000
000021200000021212121221122211112111111112000000000000000000
111200212002121202120000000222222111111222000000000000000000
000000212212121202111212212002111111111200000000000000000000
000000021212121212000211200212222222221200000000000000000000
112002121212121211200000021200000021222200000000000000000000
000212121212121200212021120000211200000000002120000000000000
121212120212121121200000000021200000000000000000000000000000
121212120212120000021200002120000000000000021200000000000000
